13 6
10 10
0 -1 0 0 0 0 0
8 1 1 0 0 1 0
9 -1 0 0 0 0 0
10 -1 0 0 0 0 0
4 -1 0 0 0 0 0
9 -1 0 0 0 0 0
8 -1 0 0 0 0 0
9 -1 0 0 0 0 0
4 -1 0 0 0 0 0
10 -1 0 0 0 0 0
9 -1 0 0 0 0 0
8 0 1 0 0 0 0
0 -1 0 0 0 0 0
6 1 1 0 0 1 0
4 1 0 0 1 1 0
8 1 1 0 0 1 0
0 -1 0 0 0 0 0
6 -1 0 0 0 0 0
9 -1 0 0 0 0 0
6 -1 0 0 0 0 0
9 -1 0 0 0 0 0
6 -1 0 0 0 0 0
0 -1 0 0 0 0 0
8 0 1 0 0 0 0
4 0 0 0 0 0 0
6 0 1 0 0 0 0
0 -1 0 0 0 0 0
1 1 1 0 0 1 0
8 -1 0 0 0 0 0
8 -1 0 0 0 0 0
9 -1 0 0 0 0 0
8 -1 0 0 0 0 0
8 -1 0 0 0 0 0
8 -1 0 0 0 0 0
9 -1 0 0 0 0 0
8 -1 0 0 0 0 0
8 -1 0 0 0 0 0
1 0 1 0 0 0 0
0 -1 0 0 0 0 0
8 -1 0 0 0 0 0
6 -1 0 0 0 0 0
0 -1 0 0 0 0 0
9 -1 0 0 0 0 0
9 -1 0 0 0 0 0
8 -1 0 0 0 0 0
6 -1 0 0 0 0 0
8 -1 0 0 0 0 0
9 -1 0 0 0 0 0
9 -1 0 0 0 0 0
0 -1 0 0 0 0 0
6 -1 0 0 0 0 0
8 -1 0 0 0 0 0
0 -1 0 0 0 0 0
8 -1 0 0 0 0 0
8 -1 0 0 0 0 0
4 -1 0 0 0 0 0
6 -1 0 0 0 0 0
10 -1 0 0 0 0 0
6 -1 0 0 0 0 0
10 -1 0 0 0 0 0
6 -1 0 0 0 0 0
4 -1 0 0 0 0 0
8 -1 0 0 0 0 0
8 -1 0 0 0 0 0
0 -1 0 0 0 0 0
8 -1 0 0 0 0 0
9 -1 0 0 0 0 0
10 -1 0 0 0 0 0
4 -1 0 0 0 0 0
8 -1 0 0 0 0 0
8 -1 0 0 0 0 0
0 -1 0 0 0 0 0
8 -1 0 0 0 0 0
8 -1 0 0 0 0 0
4 -1 0 0 0 0 0
10 -1 0 0 0 0 0
9 -1 0 0 0 0 0
8 -1 0 0 0 0 0
